11111111111111111111111
10100110100101111101001
10100110100100000101001
10010110100101111101001
10100110111101000001001
10000110000101000001001
10110110000101111101001
10001110000100000001001
10000000100000001101001
10000110001100001101001
10000110001100001101001
10000110001101001101001
11111111111111111111111
