R 1280 1280

NO ./gitler.xpm
SO ./svaston.xpm
WE ./blythe.xpm
EA ./WALL71.xpm

S ./barrel.xpm
F 123,100,0
C 102,    224,245


111111111111111111111111110
120220002200011000000000001
1000N01111110000010000001
1001000000001000000010001
1111111110110000011100001
1000000000110000011101111
1111011111111101110000001
1111011111111101110101001
1100000011010101110000001
1000000000000000110000001
1000000000000000110101001
1100000111010101111101111
1111011111110101110111101
1111111111111111111111111
